Focus command bar, search all repositories	s	Site Wide
Focus command bar, search the current repository	/	Site Wide
Go to Notifications	g n	Site Wide
Bring up this help dialog	?	Site Wide
Move selection down	j	Site Wide
Move selection up	k	Site Wide
Toggle selection	x	Site Wide
Open selection	o / enter	Site Wide
Go to Code	g c	Repositories
Go to Issues	g i	Repositories
Go to Pull Requests	g p	Repositories
Go to Wiki	g w	Repositories
Activates the file finder	t	Source code browsing
Jump to line	l	Source code browsing
Switch branch/tag	w	Source code browsing
Expand URL to its canonical form	y	Source code browsing
Show/hide all inline notes	i	Source code browsing
Submit comment	ctrl enter	Issues
Preview comment	ctrl shift p	Issues
Go fullscreen	ctrl shift l	Issues
Create issue	c	Issues
Create label	l	Issues
Back to issues	u	Issues
Focus issues search	/	Issues
Reply (quoting selected text)	r	Issues
Submit comment	ctrl enter	Browsing commits
Close form	escape	Browsing commits
Parent commit	p	Browsing commits
Other parent commit	o	Browsing commits
Expand URL to its canonical form	y	Commit list
Mark as read	e / y	Notifications
Mute thread	shift m	Notifications
Reply (quoting selected text)	r	Pull request list
Open issue	o / enter	Pull request list
Submit comment	ctrl enter	Pull request list
Preview comment	ctrl shift p	Pull request list
Go fullscreen	ctrl shift l	Pull request list
Scroll lef	← / h	Network Graph
Scroll right	→ / l	Network Graph
Scroll up	↑ / k	Network Graph
Scroll down	↓ / j	Network Graph
Toggle visibility of head labels	t	Network Graph
Scroll all the way left	shift ← / shift h	Network Graph
Scroll all the way right	shift → / shift l	Network Graph
Scroll all the way up	shift ↑ / shift k	Network Graph
Scroll all the way down	shift ↓ / shift j	Network Graph
